Humans 10
RRRRRRRRRRRRRRRRRRRRRRRRRRRRRRRRRRRRRR
R........Z...........................R
R.@..................................R
R.....Z..Z....BBBB...................R
R.............B......................R
R..Z..Z..Z....B......................R
R.............B......................R
R.......Z.....B......................R
R.............BBBB...................R
R....................................R
RRRRRRRRRRRRRRRRRRRRRRRRRRRRRRRRRRRRRR